30
30
PPPPPPPPPPPPPPPPPPPPPPPPPPPPPP
PPPPPPPPPPPPPPPPPPPPPPPPPPPPPP
PPPPPPPPPPPPPPPPPPPPPPPPPPPPPP
PPPTSTTTTTTTTTAABSSSSBBBBSSPPP
PPPSSTTTTTTTTAABBBSSBBBBSSBPPP
PPPSTTTTTTTTTAABBBBSSBBSSBBPPP
PPPTTTTTTTTTTTAABBBSSBSSBBBPPP
PPPTTTTTTTTTKTAABBSSBBSSBBBPPP
PPPTKTTTTTTTTTAABBBSSBSSBBKPPP
PPPTTTTTTTTTTAABBBSSSSSSBBBPPP
PPPTTTTKTTTTTAABBBKSSSSBBBBPPP
PPPTTTTTTTTTTAABBBSSBBSSBBBPPP
PPPTTTTTTTTTTAABBSSSSBSSBBBPPP
PPPTTTTTTTTTTTAABSSSSSSBBBSPPP
PPPTTTTTTTTTTTAABSSBSSBBBSSPPP
PPPTTTTTTTTTTTBAASSSSBSBSSBPPP
PPPTTSTSSSSSSSSSBSSBSSSSSBBPPP
PPPSSSSSMMMMMMMSSSBSSSBSBBBPPP
PPPSSTSSMSSSSSMSSBSSBBBBBBBPPP
PPPTTTTSMSSSSSMSSSSSSBBBBBBPPP
PPPTTTTSMSSSSSSSBSSSSSBBBBBPPP
PPPTTTTSMSSSSSMSBBSSBSSBBBBPPP
PPPTTTTSMSSSSSMSBSSBBSSBBBBPPP
PPPTTTTSMMMMMMMSBBSSBBSSBBBPPP
PPPTSTTSSSSSSSSSBBBSSBBSSBBPPP
PPPSSSSSTKBBBBBSSKBBSSBSSBBPPP
PPPSTSSSTTBBBBSSBBBBBBSSBBBPPP
PPPPPPPPPPPPPPPPPPPPPPPPPPPPPP
PPPPPPPPPPPPPPPPPPPPPPPPPPPPPP
PPPPPPPPPPPPPPPPPPPPPPPPPPPPPP
